#000000000000000000000000000000000000000
##00000000000000000000000000000000000000
0#00000000000000000000000000000000000000
0####00#00000000000000000000000000000000
##00000000000000000000000000000000000000
#000000000000000000000000000000000000000
#00000000#000000000000000000000000000000
0#000000##000000000000000000000000000000
00#00000#0000000000000000000000000000000
00#############0000000000000000000000000
00000000000000##000000000000000000000000
00000000000000##000000000000000000000000
00000000000000###00000000000000000000000
00000000000000###00000000000000000000000
00000000000000####0000000#0#000000000000
00000000000000####0000000#0#00000000000#
00000000000000##########################
0000000000000000000000000000000000000000
0000000000000000000000000000000000000000
0000000000000000000000000000000000000000
0000000000000000000000000000000000000000
0000000000000000000000000000000000000000
